46 24
nNNNNNNNNNNe\\\\\\\\\\\\\\\\\\\\\\\\\\\\\\\\\\
W//////////E\\\\\\\\\\\\\\\\\\\\\\\\\\\\\\\\\\
W//////////E\\\\\\\\\\\\\\\\\\\\\\\\\\\\\\\\\\
W/////B////E\\\\\\\\\\\\\\\\\\\\\\\\\\\\\\\\\\
W//////////E\\\\\\\\\\\\\\\\\\\\\\\\\\\\\\\\\\
W//////////E\\\\\\\\\\\\\\\\\\\\\\\\\\\\\\\\\\
W//////////E\\\\\\\\\\\\\\\\\\\\\\\\\\\\\\\\\\
W//////////E\\\\\\\\\\\\\\\\\\\\\\\\\\\\\\\\\\
wSST/////rNNNNNNNNNNNNNNNNNe\\\\\\\\\\\\\\\\\\
\\\W/////E/////////////////E\\\\\\\\\\\\\\\\\\
\\\W/////E/////////////////LNNNNNNNNNNNNNe\\\\
\\\W/SSS/E////////ne/////////////////////E\\\\
\\\W/////E////////WE/////////////////////E\\\\
\\\W/////E////////WE////////////W////////E\\\\
\\\W/SSS/E////////ws///////E////W////////E\\\\
\\\W/////E/////////////////E////W////O///E\\\\
\\\W/////E/////////////////E////W////////E\\\\
\\\W/SSS/LSSSSSSSSSSSSSSSSSs////wSSSSSSSSs\\\\
\\\W////////////////////////////VVVVVVVVVE\\\\
\\\W////////////////////////////VVVVVVVVVE\\\\
\\\W////////////////////////////VVVVVVVVVE\\\\
\\\W////////////////////////////VVVVVVVVVE\\\\
\\\W////////////////////////////VVVVVVVVVE\\\\
\\\wSSSSSSSSSSSSSSSSSSSSSSSSSSSSSSSSSSSSSs\\\\