35 28
nNNNNNNNNNNNNNNNNNNNNNNNNNNNNNNNNNe
W////////////////O////////////////E
W/////////////////////////////////E
W/////|SSSSSSSl/////|SSSSSSSl/////E
W/////_///////^/////_///////^/////E
W/////ENNNNNNNW/////ENNNNNNNW/////E
W/////E//\\\//W/////E//\\\//W/////E
W/////E//\\\//W/////E//\\\//W/////E
W/////E//\\\//W/////E//\\\//W/////E
W/////E//\\\//W/////E//\\\//W/////E
W/////ESSSSSSSW/////ESSSSSSSW/////E
W/////-///////~/////-///////~/////E
W/////////////////////////////////E
W/////////////////////////////////E
W//////////////ENNNNW/////////////E
W//////////////ESSSSW/////////////E
W/////////////////////////////////E
W/////_/////////////////////^/////E
W/////ENNNNNNNNNNNNNNNNNNNNNW/////E
W/////E/////////////////////W/////E
W/////E\\\\\\\\\\\\\\\\\\\\\W/////E
W/////E/////////////////////W/////E
W/////ESSSSSSSSSSSSSSSSSSSSSW/////E
W/////-/////////////////////~/////E
W/////////////////////////////////E
W/////////////////////////////////E
W////////////////B////////////////E
wSSSSSSSSSSSSSSSSSSSSSSSSSSSSSSSSSs